W W W W W W W W W W W
W W W W G D G G G G W
W W W 3 G G G G G W W
W W W W G G W G G G W
W W W W W W W G G G W
W W W W W W 3 G G W W
W W W W W W W W G W W
W W W W W W G G G G W
W W W W W W W G G G W
W W W W W W W W U G W
W W W W W W G G G G W
W W W W W W G G G G W
W W W W G G G P G W W
W W W W G G G P G G W
W W W W G G G P G W W
W W W W G G P W W W W
W W W G G G P W W W W
W W W G G G G W W W W
W W G G G G G W W W W
W W W B B B B W W W W
W W G G G G G G G W W
W W W G G 3 G G G W W
W W W W W G G G G G W
W W W W W G G G G G W
W W W W W W G G G W W
W W W W W W G G W W W
W W W W W W G G W W W
W G G G W G G G B G C
W G G G G G 3 G B G G
W W W W W W W W W W W
