W W W W W W W W W W W
W W W W G D G G G G W
W W W 3 G G G G G W W
W W W W G G W G G G W
W W W W W W W G G G W
W W W W W W 3 G G W W
W W W W W W W W G W W
W W W W W W G G G G W
W W W W W W W G G G W
W W W W W W W W U G W
W W W W W W G G G G W
W W W W W W G G G G W
W W W W G G G P G W W
W W W W G G G P G G W
W W W W G G G P G W W
W W W W G G G W W W W
W W W G G G L W W W W
W W W G G G G W W W W
W W G G G G G W W W W
W W V V B B V V W W W
W W G G G G G G G W W
W W W G G G G G G W W
W W W W W G G G G G W
W W W W W G G G G G W
W W W W W W G G G W W
W W W W W W G G W W W
W W W W W W G G W W Wh
W G G G W G G G B G C
W G G G G G G G B G G
W W W W W W W W W W W
